你 - You
好 - fine; good; nice; O.K.; it's settled
请 - please (polite form of request); to treat or to invite (somebody)
问 - To ask
贵 - honorable; expensive
姓 - Surname
我 - I; me
呢 - question particle (need context)
小姐 - Miss; young lady
叫 - To be called; to call
什么 - What
名字 - Name
先生 - Mr.; husband; teacher
李友 - Lǐ Yǒu
王朋 - wáng péng
是 - To be
老师 - Teacher
吗 - question particle
不 - Not; no
学生 - Student
也 - Too; also
人 - Person; people
中国 - China
北京 - Beijing
美国 - America
纽约 - New York
英国 - Britain
法国 - France
德国 - German
日本 - Japan
韩国 - South Korea
加拿大 - Canada
上海 - Shanghai